NO textures/abyss_blue.png
WE textures/abyss_green.png
SO textures/abyss_red.png
EA textures/abyss_white.png

F 100,100,75
C 255,100,66

      1          1
     101        101
    10001      10001
   1000001    1000001
  100000001  100000001
 100000000011000000000111111111111111111111111
100000000000E00000000000000000000000000000000111
 10000000001100000000011111111111111111111010001
10000000001  100000001                   1011101
10111000001   1000001                    10111001
101  10001     10001111111111111111111111101111001
101   1011111111110000000000000000000000000011111
101   10000000000001111111111111111111111101
101    100000000001                      101
101     1000000001                       101
101      10000001                        101
101       1000011                        101
101        100001                        101
101         11101                        101
101      11111001                        101
101      1000001                         101
101      1001111                         101
101       101                            101
101      1001                            101
101     1001                             101
10111111101111111111111111111111111111111101
10000000000000000000000000000000000000000001
11111111111111111111111111111111111111111111