111111111111111111111111
100000000000000000000001
100000000000000000000001
100000000000000000000001
100000111110000101010001
100000100010000000000001
100000100010000100010001
100000100010000000000001
100000110110000101010001
100000000000000000000001
100000000000100000000001
100000000000000000000001
100000000000100000000001
100000000001010000000001
100000000010001000000001
100000000000000100000001
111111111000000000000001
110100001000000000000001
110000101000010000000001
110100001001000000000001
110111111000000000000001
110000000000000000000001
111111111000000000000001
111111111111111111111111