NO   ./assets/textures/wall_textures/tile02.png 
WE ./assets/textures/wall_textures/tile01.png
SO ./assets/textures/wall_textures/tile03.png
EA	./assets/textures/wall_textures/tile04.png

C 47,55,66
F 255,75,123

			111111111111111111111111
			100000000000000000000001
			100000000000000000000001
			100000000000000000000001
			100000111110000101010001
			100000100010000000000001
			100000100010000100010001
			100000100010000000000001
			100000110110000101010001
111111111111111111111111
1011111100000000000000001
101    10000100000000001
101111110000000000000001
100000000000100000000001
100000000001010000000011
100000000010001000000101
100000000000000100000001
111111111000000000000001
110100001000000000000001
110000101000010000000001
110100001001000000000001
110111111000000W00000001
110000000000000000000001
111111111000000000000001
111111111111111111111111