NO textures/eagle.png 
WE textures/bluestone.png
SO textures/mossy.png
EA textures/wood.png
C 255,255,255
F 255,1,1

111111111111111111111111
10000000000000000S0000011
10000000000000011111000001
1000000000000001   100011
100000000000000111110001
100000000000000000000001
111111111111111111111111
