F                                       200,100,0                  


 11111111111111111111111111111
C 244,233,120

NO ./assets/textures/wall_textures/tile02.png
WE ./assets/textures/wall_textures/tile01.png
SO ./assets/textures/wall_textures/tile03.png 
EA ./assets/textures/wall_textures/tile04.png


EA ./assets/textures/wall_textures/tile04.png

         11111111111111111111111111111
 1  111111000000000110001000000001
1011000001110000000000001
1001000000000S00000000001
1001000000000000000000001
1011000000100000000000001
1000000001010000000000001
1001000000100000000000001
1011000001110000000000001
1000000000110000000000001
1001000000000000000000001
1011000001110000000000001
1000000000110000000000001
1000000000000000000000001
1111111111111111111111111

