NO textures/greystone.png
WE textures/colorstone.png
C 0,55,66
F 255,75,123                
1111111111111111111111111
1000000000110000000000001
1111111111111111111111111