



NO textures/greystone.png
WE textures/colorstone.png
SO textures/eagle.png                                   

C                               55,55,66
F 0,120,30      
F 0,120,30

EA                      textures/greenlight.png

1111111111111111111111111
1000000000110000000000001
1011000001110000000000001
1001000000000000000000001
1001000000000000000000001
1011000000100000000000001
1000000001010000000000001
1001000000100000000000001
10110000011100N0000000001
1000000000110000000000001
1001000000000000000000001
1011000001110000000000001
1000000000110000000000001
1000000000000000000000001
1111111111111111111111111









